7,28,28,8,2,18,15,35,20,3,32,31,1,2,1,1,32,3,133,19,2
28,133,40,28,18,20,2,2,1,7,13,31,34,1,146,1,32,31,1,34,1
10,28,28,13,27,39,1,1,34,26,19,1,1,1,16,3,34,10,27,27,4
2,1,18,34,20,1,1,3,7,9,3,1,2,1,21,26,20,1,16,1,3
15,15,20,1,2,3,28,28,9,2,21,34,115,19,1,2,1,1,34,1,1
1,39,1,7,28,32,31,1,1,1,1,1,3,16,34,1,1,3,21,115,19
43,1,7,9,34,28,31,2,2,1,112,1,3,16,1,1,3,1,1,2,116
27,27,9,2,27,1,1,1,1,34,19,1,34,21,26,19,1,1,18,115,34
2,21,19,1,21,19,34,1,1,1,27,3,1,1,2,116,1,34,16,1,1
1,1,16,34,1,116,2,1,1,3,27,1,1,1,34,21,19,1,21,19,2
34,115,20,1,1,21,26,19,34,1,21,34,1,1,1,1,27,2,7,27,27
116,2,1,1,3,1,1,16,3,1,112,1,2,2,32,28,34,7,9,1,34
21,115,19,3,1,1,34,16,3,1,1,1,1,1,32,31,28,9,1,44,1
1,1,34,1,1,2,1,21,115,34,19,2,7,28,28,3,2,1,18,15,15
3,1,16,1,18,26,19,1,2,1,3,7,9,3,1,1,18,34,20,1,2
4,27,27,8,34,3,16,1,1,1,21,26,34,1,1,44,27,11,28,28,8
1,34,1,32,31,1,140,1,34,32,11,9,1,2,2,18,20,28,45,133,28
2,21,133,3,31,1,1,2,1,32,31,3,18,35,15,20,2,10,28,28,9
