30,133,1,32,28,28,28,28,28,28,28,28,28,28,32,32,28,28,31,3,36,21,20,1,32
1,28,28,28,28,28,31,3,30,28,37,1,30,31,34,1,32,28,28,28,28,31,1,133,3
29,28,28,28,28,31,47,44,1,3,1,1,18,112,20,3,34,1,32,28,28,28,28,31,1
28,31,31,28,28,31,1,21,34,1,1,3,34,1,2,1,16,3,1,35,32,28,28,28,29
28,42,1,31,28,28,31,1,1,112,18,15,20,1,3,1,21,15,15,19,1,42,37,32,28
28,31,34,3,32,28,28,28,3,1,34,2,1,1,34,112,1,1,34,21,19,32,28,28,28
28,31,1,3,34,2,32,28,28,31,3,34,1,1,1,1,1,2,1,3,16,28,28,28,28
31,35,15,19,3,1,1,34,30,28,31,1,3,30,4,29,3,1,29,29,34,3,28,28,28
31,1,2,16,1,1,1,16,3,28,28,29,29,28,44,5,34,1,30,30,3,1,32,28,28
28,31,3,21,19,3,1,21,19,34,32,30,29,30,28,29,16,112,1,1,2,1,1,28,28
28,28,34,1,16,34,1,2,16,1,31,29,145,30,32,1,16,2,1,34,16,1,34,28,28
28,28,1,1,2,1,1,112,16,30,28,29,30,29,31,34,21,19,1,3,21,19,3,32,28
28,28,31,1,3,29,29,1,34,5,44,28,30,30,28,28,3,16,1,1,1,16,2,1,32
28,28,28,3,34,30,30,1,3,30,4,29,3,1,32,28,29,34,1,1,3,21,15,35,32
28,28,28,28,16,3,1,2,1,1,1,1,1,34,3,32,28,28,31,2,34,3,1,32,28
28,28,28,31,21,19,34,1,1,112,34,1,1,2,34,1,3,28,28,28,31,3,34,32,28
28,31,37,47,1,21,15,15,19,1,3,1,18,15,20,112,1,1,32,28,28,32,1,47,28
30,28,28,28,31,35,1,3,16,1,2,1,34,3,1,1,34,19,1,32,28,28,32,32,28
1,32,28,28,28,28,31,1,34,3,18,112,20,1,1,3,1,44,42,32,28,28,28,28,30
3,133,1,32,28,28,28,28,31,1,34,32,29,1,37,28,29,3,32,28,28,28,28,28,1
31,1,18,19,36,3,32,28,28,31,31,28,28,28,28,28,28,28,28,28,28,31,1,133,29
