3,30,30,28,28,28,28,28,28,2,34,1,3,3,44,3,18,34,2,2,34,3,1,1,3,2,2
34,2,30,30,34,28,28,33,28,28,1,1,1,2,2,1,112,2,2,1,1,1,1,1,34,1,3
2,2,30,30,1,1,28,28,28,28,29,140,112,19,2,1,34,2,1,3,1,34,3,1,21,15,19
30,30,30,133,3,38,28,28,31,28,28,29,29,34,1,1,1,3,1,1,1,3,18,112,1,107,21
31,112,3,1,2,2,28,28,31,2,30,28,31,1,3,1,1,1,1,112,1,3,16,3,1,101,1
28,28,38,1,2,28,28,28,31,2,2,30,28,29,29,29,29,37,3,1,1,133,20,1,1,101,36
33,28,28,28,28,28,28,30,35,3,34,2,2,3,1,29,29,29,29,3,1,1,1,1,34,101,34
28,28,28,28,33,28,30,2,2,1,1,1,1,34,1,1,34,28,29,29,29,3,3,1,1,114,112
32,28,2,28,28,2,35,3,112,15,19,3,1,1,3,3,27,30,28,29,29,29,34,1,1,109,1
2,2,2,34,30,1,3,34,2,2,34,3,1,2,1,18,20,1,140,1,32,28,29,1,3,2,39
2,104,102,108,32,1,2,2,2,1,21,15,19,1,3,34,2,3,1,1,30,34,28,2,1,1,3
102,106,34,2,28,29,29,3,1,1,1,3,21,15,19,3,1,1,1,3,30,30,28,2,34,104,102
3,1,1,2,28,34,29,1,1,3,2,34,3,1,21,15,19,1,2,2,2,1,31,110,102,106,2
44,2,3,1,30,28,31,1,146,1,18,20,1,2,1,3,34,2,2,34,3,1,29,34,2,2,2
1,107,1,1,34,30,30,30,28,29,27,3,3,1,1,3,21,15,112,3,44,2,28,28,2,28,31
112,114,1,1,3,3,30,30,30,28,34,1,1,34,1,1,1,1,2,2,29,28,33,28,28,28,28
34,101,34,1,1,1,1,3,30,30,30,30,1,3,2,2,34,3,35,29,28,28,28,28,28,28,33
36,101,1,1,18,133,1,1,3,37,30,30,30,30,28,29,2,2,32,28,28,28,2,1,43,28,28
1,101,1,3,16,3,1,112,1,1,1,1,3,1,32,28,29,2,32,28,28,2,2,1,3,112,32
19,109,1,112,20,3,1,1,1,3,1,1,1,34,30,30,28,28,32,28,28,43,3,133,29,29,29
21,15,19,1,3,34,1,3,1,2,34,1,2,21,112,146,30,28,28,28,28,1,1,29,29,2,2
3,1,34,1,1,1,1,1,2,2,112,1,2,2,1,1,1,28,28,33,28,28,34,29,29,2,34
2,2,3,1,1,3,34,2,2,34,20,3,39,3,3,1,34,2,28,28,28,28,28,28,29,29,3
