33,29,34,3,3,36,1,1,3,32,32,34,1,1,32,133,30,30,30,27,2,2
30,30,27,29,29,1,1,39,2,34,26,19,3,32,32,28,30,18,15,20,34,2
133,26,23,30,30,2,1,1,2,2,32,21,2,26,15,19,1,16,34,1,1,2
29,29,39,2,3,35,3,1,1,1,32,32,28,32,3,34,1,21,19,3,1,1
30,30,2,2,1,2,2,18,34,1,3,1,1,32,31,16,1,1,16,1,1,34
36,3,1,1,1,34,15,20,3,28,32,34,1,1,31,16,3,1,34,2,32,32
2,2,34,15,19,2,3,28,32,32,32,27,3,1,1,34,1,1,2,2,32,32
2,2,2,3,16,30,30,28,1,1,32,27,1,34,1,21,15,19,1,3,1,32
28,28,28,31,27,30,1,1,3,18,26,24,15,15,112,1,1,34,26,19,47,32
28,28,30,31,21,34,1,1,1,34,32,31,1,1,1,2,3,1,32,21,15,32
31,15,19,31,1,3,2,1,1,1,32,31,34,1,1,1,34,19,32,29,28,28
31,42,21,26,34,1,1,112,15,15,22,26,20,3,1,1,29,27,32,28,28,28
31,1,3,1,21,15,19,1,34,1,27,31,1,1,28,29,29,16,3,2,2,2
31,31,2,2,1,1,34,1,1,3,27,31,31,31,28,3,2,21,15,34,2,2
31,31,2,34,1,3,16,32,1,1,34,31,28,3,18,15,34,1,1,1,3,36
34,1,1,16,1,1,16,32,31,1,1,3,1,34,20,2,2,1,2,2,29,29
1,1,3,21,19,1,34,3,31,28,31,31,1,1,1,3,35,3,2,44,30,30
2,1,1,34,16,1,21,15,26,2,19,31,2,2,1,1,2,29,29,25,26,133
2,34,18,15,20,29,28,31,31,3,21,26,34,2,44,1,1,30,30,27,29,29
2,2,27,29,29,29,133,31,1,1,34,31,31,3,1,1,36,3,3,34,30,33
