28,31,35,1,1,34,1,34,1,1,1,1,2,2,1,1,1,133,1,34,3
30,34,1,1,1,1,1,1,3,1,18,34,1,1,3,34,18,15,26,15,19
39,1,36,1,1,18,19,1,34,1,16,1,1,3,1,1,16,112,1,140,20
115,113,102,102,108,34,20,34,1,1,27,1,1,2,2,2,27,1,3,112,34
2,3,34,29,29,29,29,32,1,2,112,3,2,2,29,29,29,29,1,1,1
3,34,2,32,28,28,28,32,3,1,21,34,1,1,28,28,28,31,1,1,1
3,2,1,3,30,30,1,2,1,133,1,1,1,1,28,30,28,10,31,34,1
1,1,1,34,2,5,34,1,1,3,1,1,18,34,2,35,3,34,5,1,1
34,1,1,1,1,14,8,1,1,1,3,34,20,1,14,8,44,1,2,1,1
1,1,2,1,39,10,12,1,18,34,3,1,1,1,10,12,1,1,1,1,34
1,1,5,34,3,39,2,34,20,1,1,3,1,1,34,5,2,34,1,1,1
1,34,32,8,28,29,28,1,1,1,1,133,1,2,1,29,29,3,1,2,3
1,1,1,32,28,28,28,1,1,34,19,1,3,31,28,28,28,31,2,34,3
1,1,1,30,30,30,30,2,2,3,112,2,1,31,30,30,30,30,34,3,2
34,112,3,1,27,2,2,2,1,1,27,1,1,34,18,34,110,102,102,113,115
18,146,1,112,16,1,1,3,1,1,16,1,34,1,21,20,1,1,36,1,44
21,15,26,15,20,34,3,1,1,34,20,1,3,1,1,1,1,1,1,34,29
3,34,1,133,1,1,1,2,2,1,1,1,1,34,1,34,1,1,35,32,28
