28,28,28,33,28,28,28,31,34,31,31,3,3,34,32,32,30,28,33,31,103,133,2
28,30,30,28,28,30,30,2,106,31,1,112,20,30,30,1,37,30,28,28,31,101,36
33,30,2,28,30,30,1,1,3,31,34,2,28,28,31,105,1,2,34,28,31,101,3
31,2,133,28,34,2,3,2,29,29,29,29,31,34,31,101,3,1,3,2,28,28,29
31,36,32,28,28,2,39,2,32,146,30,30,1,18,31,114,1,112,1,3,44,28,28
28,28,28,28,29,29,29,43,31,2,18,26,34,16,28,106,18,3,2,1,112,19,28
28,31,2,3,34,32,33,29,31,18,20,1,1,27,28,2,34,19,1,1,2,37,32
31,31,3,1,2,3,32,31,2,2,3,112,1,3,32,29,2,21,3,35,29,29,30
31,41,1,2,2,2,32,31,1,1,1,34,1,1,1,30,30,30,28,30,30,3,1
31,2,2,2,3,34,3,28,2,3,28,31,2,3,1,3,34,2,31,1,3,18,34
2,2,34,3,1,32,30,30,34,1,29,32,3,1,1,1,3,32,31,1,18,20,2
2,18,20,1,32,31,3,1,1,1,3,31,30,1,34,29,29,31,1,3,34,2,2
34,20,3,1,32,2,34,3,1,3,2,32,28,3,2,28,3,34,3,2,2,2,32
1,3,29,29,28,29,29,29,1,1,1,34,1,1,1,32,31,2,2,2,1,46,32
29,30,30,35,3,19,2,30,31,3,1,112,3,2,2,32,31,3,2,1,3,32,32
31,37,2,1,1,21,34,2,28,27,1,1,18,20,32,30,33,31,34,3,2,32,28
28,21,112,1,2,3,20,104,28,16,34,26,20,2,32,34,30,30,30,28,28,28,28
28,28,39,3,1,112,1,114,32,20,1,29,29,140,31,2,44,2,28,28,31,36,32
30,28,28,2,3,1,3,101,32,34,32,30,30,30,30,2,3,2,34,28,133,2,32
3,101,32,28,34,2,1,103,32,28,28,2,34,32,3,1,1,29,29,28,2,29,33
36,101,32,28,28,29,37,1,29,29,18,112,1,32,104,2,29,29,28,28,29,29,28
2,133,105,32,33,28,29,31,31,34,3,3,32,32,34,32,28,28,28,33,28,28,28
