2,1,34,19,42,1,36,1,3,26,34,22,15,19,34,18,15,35,2,34
1,1,3,16,112,1,1,2,1,114,3,39,3,16,3,16,2,1,1,2
1,34,112,21,115,19,3,1,34,5,3,3,2,16,2,39,3,112,1,7
1,34,112,1,1,34,1,1,1,10,27,28,34,20,3,3,7,113,27,9
3,112,1,112,1,112,1,1,3,1,116,10,27,8,7,28,9,34,20,1
18,19,1,34,1,28,1,133,18,115,20,1,3,10,9,1,1,3,3,1
16,34,1,112,19,112,112,18,20,34,28,1,34,1,1,1,34,2,18,34
21,19,1,1,21,112,34,21,19,1,18,19,1,1,1,1,28,1,116,1
1,16,1,1,3,34,1,3,16,18,20,16,3,1,34,3,1,1,16,1
1,116,1,28,1,1,1,1,21,20,1,21,19,34,112,19,1,1,21,19
34,20,2,34,1,1,1,34,1,28,34,18,20,112,112,21,112,1,34,16
1,3,3,1,1,7,8,3,1,18,115,20,133,1,28,1,34,1,21,20
1,18,34,7,28,9,10,27,8,116,1,3,1,1,112,1,112,1,112,3
7,27,113,9,3,3,18,34,28,27,8,1,1,1,34,1,1,112,34,1
9,1,112,3,44,2,16,2,3,3,5,34,1,3,21,115,19,112,34,1
2,1,1,2,16,3,16,3,44,3,114,1,2,1,1,112,16,3,1,1
34,2,35,15,20,34,21,15,24,34,26,3,1,36,1,47,21,34,1,2
