2,2,3,3,1,1,34,34,2,1,1,2,2,3,5,3,1,2,133
2,34,15,15,19,1,1,1,3,18,15,35,1,3,26,39,1,2,2
3,1,1,2,16,42,29,31,18,20,1,1,1,1,5,1,1,3,2
1,1,34,18,20,3,32,30,21,19,34,1,3,1,10,8,34,1,34
34,15,15,20,1,1,1,1,1,21,19,2,1,1,1,10,27,8,16
1,3,29,29,1,34,2,1,3,29,29,31,2,1,34,1,39,10,27
29,29,30,30,1,1,2,1,1,32,28,31,1,1,1,1,1,18,20
28,30,1,133,1,1,1,1,1,32,30,30,34,1,3,1,18,20,3
30,1,3,1,32,29,34,3,1,1,21,15,19,1,1,18,20,1,1
110,105,1,1,30,31,1,1,34,1,1,3,21,34,15,20,1,3,1
36,109,34,1,1,1,1,1,1,2,1,1,1,1,1,1,34,107,36
1,3,1,18,15,34,19,3,1,1,34,1,1,32,29,1,1,103,108
1,1,18,20,1,1,21,15,19,1,1,3,34,30,31,1,3,1,29
3,18,20,1,3,1,34,29,29,31,1,1,1,1,1,133,1,29,28
18,20,1,1,1,1,1,32,28,31,1,1,2,1,1,29,29,30,30
27,8,44,1,38,1,2,32,30,30,3,1,2,34,1,30,30,3,1
16,10,27,8,1,1,1,2,21,19,1,1,1,1,1,18,15,15,34
34,1,34,10,8,1,3,1,34,21,19,29,31,3,18,20,34,1,1
2,3,1,1,5,1,1,1,1,18,20,32,30,47,16,2,1,1,3
2,2,1,44,26,3,1,35,15,20,3,1,1,1,21,15,15,34,2
133,2,1,3,5,3,2,2,1,1,2,34,34,1,1,3,3,2,2
